NO ./imgs/stonewall.xpm
SO ./imgs/darkstonewall.xpm
WE ./imgs/redbrickwall.xpm
EA ./imgs/redbrickwallflag.xpm

F 220,100,0
C 225,30,0

  1111
 100001
 10N101
 10001
 1111111