NO ./imgs/redbrickwallnazi.xpm
SO ./imgs/stonewalleagle.xpm
WE ./imgs/stonewallhitler.xpm
EA ./imgs/stonewallnazi.xpm

F 220,100,0
C 225,30,0

11111111111111111111111111111111111
10000000100000000001000000000000001
10100010100010000001000000000000001
1010S010100010000001000000000000001
10111110100010000001111111000111111
10000000000010000001000001000000001
10000000011111100001000001000000001
10000000000000000000000001000000001
11111110000000000000111101000000001
10000100000001111000100001001000001
10000100000000001000100000001000001
10000101111110001000100000001000001
10000100000000001000100111111000001
10000000000000000000100000001000001
11111111111111111111111111111111111
