NO ./imgs/stonewall.xpm
SO ./imgs/darkstonewall.xpm
WE ./imgs/redbrickwall.xpm
EA ./imgs/redbrickwallflag.xpm

F 220,100,0
C 225,30,0

111111111111111111111111111111111111111111111111
100000000000000000000000000000000000000000000001
100000000000000000000000000000000000000000000001
100000000000000000000000000000000000000000000001
100000000000000000000000000000000000000000000001
100000000000000000000000000000000000000000000001
100000000000000010000000000000000000000000000001
100000000000000010000000000000000000000000000001
100000000000000010000000000000000000000000000001
100000000000000000000000000000000000000000000001
100000000000000000000000000W00000000000000000001
100000000000000000000000000000000000000000000001
100000000000000000000000000000000000000000000001
100000000000000000000000000000000000000000000001
100000000000000000000000000000000000000000000001
111111111111111111111111111111111111111111111111
