NO ./imgs/stonewall.xpm
SO ./imgs/darkstonewall.xpm
WE ./imgs/redbrickwall.xpm
EA ./imgs/redbrickwallflag.xpm

F 220,100,0
C 225,-30,256

11111
10001
10N01
10001
11111